11111111111111
10000000000001
1000000C000001
100C00000000E1
1P000000000001
10000000000001
10000000000001
11111111111111
