11111111111111
10000000000001
1000000C100001
100C00001000E1
1P000000100001
10000000100001
1000000010B001
11111111111111
