11111111111111
10000000100001
1000000C100001
100C00001E0001
1P000000000001
10000000100001
100000001B0001
11111111111111
